1111111111111
100100CCCC0C1
11100111100C1
100011E00P001
1111111111111