1111111111111
10CC00000C001
1P1111CC000C1
10000CE0000C1
1111111111111